WWWWWGGGGGGGWWWWWWWGGGGWWWWWWWWWWGGGGGGGGWWWWWWWWWW
WWWWWGGGGGGGGGGGGGGGGGGGWWWWWWWWWWGGGGGGGGWWWWWWWWW
WWWWWWGGGGGGGGGGGGGGGGGGWWWWWWWWWWGGGGGGGWWWWOOOWWW
WWWWWWGGGGGGGGGGGGGGGGGWWWWWWWWWWWWWGGWWWWWWWOOOWWW
WWWWWWWWWWWWGGGGGGGWWWWWWWWWWWWWWWWWWWWWWWWWWOOOWWW
WWWWWWWWWWWWWWWWWWWWWWWWWWWWWWWWWWWWWWWWWWWWWWWWWWW
WWWWWWWWWWWWWWWWWWWWWWWWWWWWWWWWWWWGWWWWWWWWWWWWWWW
WWWWWWWWWWWWWWWWWWWWWWWWWWWWWWWWGGGGWWWWWWWWWWWWWWW
WWWWWWWWWWWWWWWWWWWOOOWWWWWWWWWGGGGGWWWWWWWWWWWWWWW
WWWWWWWWWWWWWWWWWWWOOOWWWWWWWWWGGGGWWWWWWWWWWWWWWWW
WWWWWWWWWWWWWWWWWWWOOOWWWWWWWWWGGGGWWWWWWWWWWWWWWWW
WWWWWWWWWWWWWWWWWWWWWWWWWWWWWWGGGGGWWWWWWWWWWWWWWWW
WWWWWWWWWWWWWWWWWWWWWWWWWWWWWWGGGGGWWWWWWWWWWWWWWWW
WWWWWWWWWWWWWWWWWWWWWWWWWWWWWWGGGGGWWWWWWWWWWWWWWWW
WWWWWWWWWWWWWWWWWWWWWWWWWWWWWWWGGGGGWWWWWWWWWWWWWWW
WWWWWWWWWGGGGWWWWWWWWWWWWWWWWWWGGGGGWWWWWWWWWWWWWWW
WWWWWWWWGGGGGWWWWWWWWWWWWWWWWWWWWWGWWWWWWWWWWWWWWWW
WWWWWWWGGGGGGGWWWWWWWWOOOWWWWWWWWWWWWWWWWWWWWWWWWWW
WWWWWWWGGGGGGGWWWWWWWWOOOWWWWWWWWWWWWWWWWOOOWWWWWWW
WWWWWWWGGGGGGGGWWWWWWWOOOWWWWWWWWWWWWWWWWOOOWWWWWWW
WWWWWWWGGGGGGGGWWWWWWWWWWWWWWWWWWWWWWWWWWOOOWWWWWWW
WWWWWWWGGGGGGGGGWWWWWWWWWWWWWWWWWWWWWWWWWWWWWWWWWWW
WWWWWWWWWGGGGGWWWWWWWWWWWWWWWWWWWWWWWWWWWWWWWWWWWWW
WWWWWWWWWWWWGWWWWWWWWWWWWWWWWWWWWWWWWWWWWWWWWWWWWWW
WWWWWWWWWWWWWWWWWWWWWWWWWWWWWWWWWWWWWWWWWWWWWWWWWWW
WWWWWWWWWWWWWWWWWWWWWWWWWWWWWWWWWWWWWWWWWWWWWWWWWWW
WWWWWWWWWWWWWWWWWWWWWWWWWWWWWWWWWWWWWWWWWWWWWWWWWWW
WWWWWWWWWWWWWWWWWWWWWWWWWWWWWWWWWWWWWWWWWWWWWWWWWWW
WWWWWWWWWWWWWWWWWWWWWWWWWWWWWWWWWWWWWWWWWWWWWWWWWWW
WWWWWWWWWWWWWOOOWWWWWWWWWWWWWWWWWWWWWWWWWWWWWWWWWWW
WWWWWWWWWWWWWOOOWWWWWWWWWWWWWWWWWWWWWWWWWWWWWWWWWWW
WWWWWWWWWWWWWOOOWWWWWWWWWWWWWWWWWWWWWWWWWWWWWWWWWWW
WWWWWWWWWWWWWWWWWWWWWWWWWWWWWGGGGWWWWWWWWWWWWWWWWWW
WWWWWWWWWWWWWWWWWWWWWWWWWWWWGGGGGGGGGGWWWWWWWWWWWWW
WWWWWWWWWWWWWWWWWWWWWWWWWWWGGGGGGGGGGGWWWWWWWWWWWWW
WGGWWWWWWWWWWWWWWWWWWWWWWWWGGGGGGGGGGGGGGWWWWWWWWWW
GGGGWWWWWWWWWWWWWWWWWWWWWWGGGGGGGGGGGGGGGWWWWWWWWWW
GGGGGGGGWWWWWWWWWWWWWWWWWWGGGGGGGGGGGGGGGWWWWWWWWWW
WGGGGGGGGWWWWWWWWWWWWWWWWGGGGGGGGGGGGGGGGGGWWWWWWWW
WWGGWWWWWWWWWWWWWWWWWWWWGGGGGGGGGGGGGGGGGGGGGWWWWWW
WWWWWWWWWWWWWWWWWWWWWWWWWWWWWGGGGGGGGGGGGGWWWWWWWWW